11111111111111111111111111111111111111111111111111111111111111111111111111111111
10000000000000000000000000000000000000000000000000000000000000000000000000000001
10001111111111111111111100000000111111110000111111110000000000001111000000000001
10001111111111111111111110011000111111111000111111111001100110001111100110011001
10000000000000000000000110011000000000011000000000011001100110000001100110011001
10000000000011110000000110011000000000011111000000011111100111111111111111111001
10011001100011111001100110011001100110001111100110001111100011111111111111111001
10011001100000011001100110011001100110000001100110000001100000000000000000011001
10011001111111111001100111111111100111110001100110001111100000000000000011111001
10011000111111111001100011111111100011111001100110001111100110011001100011111001
10011000000000011001100000000001100000011001100110000001100110011001100000011001
10011111000011111001100011110001111100011001100110000001100111111001100000011001
10001111100011111001100011111000111110011001100110011001100011111001100110011001
10000001100000011001100000011000000110011001100110011001100000011001100110011001
10000001111111111001100011111000000110011111100110011001100011111111100110011001
10011000111111111001100011111001100110001111100110011001100011111111100110011001
10011000000000011001100000011001100110000001100110011001100000000001100110011001
10011000000000011111111111111111111110000001111111111111111100000001111110011001
10011001100110001111111111111111111110011000111111111111111110011000111110011001
10011001100110000000000000000000000110011000000000000000000110011000000110011001
10011001111111111111000000000000000111111111000000001111000111111000000110011001
10011000111111111111100110011001100011111111100110001111100011111001100110011001
10011000000000000001100110011001100000000001100110000001100000011001100110011001
10011000000000000001100110011111111111110001100110001111111111111001100110011111
10011001100110011001100110001111111111111001100110001111111111111001100110001111
10011001100110011001100110000000000000011001100110000000000000011001100110000001
10011001111110011001111110001111111100011111100110001111111100011001100110001111
10011000111110011000111110001111111110001111100110001111111110011001100110001111
10011000000110011000000110000000000110000001100110000000000110011001100110000001
10011000111110011111000111110000000111110001111111111111000111111001100110001111
10011000111110001111100011111001100011111000111111111111100011111001100110001111
10011000000110000001100000011001100000011000000000000001100000011001100110000001
10011111111110001111111111111111111111111111000000000001111111111001111110000001
10001111111110001111111111111111111111111111100110011000111111111000111110011001
10000000000110000000000000000000000000000001100110011000000000011000000110011001
10000000111111110000000000001111000011111111111110011111111111111000111111111001
10011000111111111001100110001111100011111111111110001111111111111000111111111001
10011000000000011001100110000001100000000000000110000000000000011000000000011001
10011111000011111111111110001111111100000000000110001111111100011000111111111001
10001111100011111111111110001111111110011001100110001111111110011000111111111001
10000001100000000000000110000000000110011001100110000000000110011000000000011001
10000001111111110000111110001111000111111001111111110000111110011111111100011111
10011000111111111000111110001111100011111000111111111000111110001111111110001111
10011000000000011000000110000001100000011000000000011000000110000000000110000001
10011111000000011111000110000001100000011111111111111000000111111111000111110001
10001111100110001111100110011001100110001111111111111001100011111111100011111001
10000001100110000001100110011001100110000000000000011001100000000001100000011001
10000001100110001111100111111111111111110000000000011001100000001111100011111111
10011001100110001111100011111111111111111001100110011001100110001111100011111111
10011001100110000001100000000000000000011001100110011001100110000001100000000001
10011111111110000001100000000000111111111001111110011111100110001111100000001111
10001111111110011001100110011000111111111000111110001111100110001111100110001111
10000000000110011001100110011000000000011000000110000001100110000001100110000001
10000000000110011001100110011111111111111111111110000001111111111111111110000001
10011001100110011001100110001111111111111111111110011000111111111111111110011001
10011001100110011001100110000000000000000000000110011000000000000000000110011001
10011001111110011111100111110000000000001111000111111111111100001111000110011111
10011000111110001111100011111001100110001111100011111111111110001111100110001111
10011000000110000401100020011001100110000001100000000000000110000001100110000001
11111111111111111111111111111111111111111111111111111111111111111111111111111111