#####################
#   #     #     # # #
# # # ### ##### # # #
# # #   #     # #   #
# ####### # ### # # #
#         #     # # #
# ### ##### ##### # #
# #   #   # #     # #
# ##### # # # ### # X
@     # # # # # # ###
##### # # # # # # # #
#     # # #   # # # #
# ####### ##### # # #
#       #       #   #
#####################