11111111111111111111111111111111111111111111111111111111111111111111111111111111
10000000000110000000000000000000000000011000000110000000000000011000000000000001
10011111100110011111111111111111111110011001100110011111100111111001111111111001
10011111100110011111111111111111111110011001100110011111100111111001111111111001
10011000000110011000000000011000000000000001100110000001100000000001100000000001
10011001100110011001111110011111111111111111100111111001111111111111100111111001
10011001100110011001111110011111111111111111100111111001111111111111100111111001
10011001100110011001100000011000000000000001100000011001100000011000000110000001
10011001100110011001100111111001111111111001111110011001100110011001111110011111
10011001100110011001100111111001111111111001111110011001100110011001111110011111
10011001100110000001100000000000000000011001100110011001100110000001100110000001
10011001100111111111111111111111111111111001100110011111100111111111100111111001
10011001100111111111111111111111111111111001100110011111100111111111100111111001
10011001100110000001100110000000000000000001100000000001100000000001100000011001
11111001100110011001100110011111111110011111111111111001111111111001111110011001
11111001100110011001100110011111111110011111111111111001111111111001111110011001
10000001100110011000000110000001100000011000000110000000000000011000000110011001
10011111100110011111100111111001111111111001100111111111111110011111100110011001
10011111100110011111100111111001111111111001100111111111111110011111100110011001
10011000000110011001100000011000000000000001100000000001100000000000000110011001
10011111100110011001100111111111111111111111111111111001100111111111111110011001
10011111100110011001100111111111111111111111111111111001100111111111111110011001
10000001100000011000000110000001100000000000000000011001100110000001100000011001
11111001111110011111111110011001100111111001111111111001111110011001100111111001
11111001111110011111111110011001100111111001111111111001111110011001100111111001
10000001100000011000000000011000000110011001100000011000000000011001100000000001
10011111100111111001111111111111111110011001100110011111111111111001111111111001
10011111100111111001111111111111111110011001100110011111111111111001111111111001
10000001100000011001100000000001100000011000000110000001100000011000000000011001
11111001111110011001100111111001111110011111111110011001100110011111111110011001
11111001111110011001100111111001111110011111111110011001100110011111111110011001
10000001100000011001100000011000000000000001100000011000000110000000000110011001
10011111111110011001100110011111111111111001100111111111111110011111111111111001
10011111111110011001100110011111111111111001100111111111111110011111111111111001
10011000000110011001100110000000000110011001100110000001100000011000000000011001
10011001100111111001100111111111100110011001100110011001111111111001111110011001
10011001100111111001100111111111100110011001100110011001111111111001111110011001
10011001100000000001100110000000000110011001100110011001100000000001100000011001
10011001111111111111111110011111111110011001100110011001100111111111100110011001
10011001111111111111111110011111111110011001100110011001100111111111100110011001
10011001100000000000000110011000000110000001100000011000000000000001100110011001
10011001111111111001100110011001100111111001111111111111111111111111100111111001
10011001111111111001100110011001100111111001111111111111111111111111100111111001
10000001100000011001100000011001100000011000000110011000000000000000000110000001
10011111100110011001111111111001111110011111100110011001111111111111111110011111
10011111100110011001111111111001111110011111100110011001111111111111111110011111
10011000000110000001100000000001100000011001100110011000000000000000000110000001
10011001111111111001100111111111111110011001100110011111111111111111100111111001
10011001111111111001100111111111111110011001100110011111111111111111100111111001
10000001100110000001100000000000000110011000000000011000000110000000000110000001
11111111100110011111111111111111100110011111111111111001100110011111100110011111
11111111100110011111111111111111100110011111111111111001100110011111100110011111
10000000000110000000000000011000000110000000000000000001100000011000000110000001
10011001111111111111111110011001100111111111100111111111111111111111111111111001
10011001111111111111111110011001100111111111100111111111111111111111111111111001
10011001100000000000000000011001100110000001100110000000000110000000000000000001
10011001100111111111111111111001111110011001111110011111100110011111111111111111
10011001100111111111111111111001111110011001111110011111100110011111111111111111
10011000000000000000000000011000000000011000000000000001100000000000000000000001
11111111111111111111111111111111111111111111111111111111111111111111111111111111
