111111111111111111111
100010000010000010101
101010111011111010101
101010001000001010001
101111111010111010101
100000000010000010101
101110111110111110101
101000100010100000101
101111101010101110100
200000101010101010111
111110101010101010101
100000101010001010101
101111111011111010101
100000001000000010001
111111111111111111111