1111111111111111111111111111111111111111
1001000100010001000000010001000000000001
1001100110011001111110011001111111111001
1001100111111001111111111001111111111111
1000100100011000000100001000000100000000
1111111111111111111111111111111111111111
1001111111111001111110011111111110011001
1001000100001001000110000001000010001001
1001100111111001111111111001111111111111
1001111110011111100110011111100110011111
1001000110000001100010010001100010010001
1001111111111001111110011111111110011001
1001100110011111100111111001100111111001
1001100110010001100100011000100100011000
1001111110011111100110011111100110011111
1001111110011001111110011001100110011111
1001000110011001000110001001100110010001
1001100110011111100111111001100111111001
1001100110011111100111111001100110011111
1001100110010001100000011001100110010001
1001111110011001111110011001100110011111
1001100111111001100110011111100110011111
1001100100011000100110010001100110010001
1001100110011111100111111001100110011111
1001111111111001100111111111111110011001
1001000100001001100100010000000110011001
1001100111111001100110011111100110011111
1001111111111001111111111111111110011111
1001000100001001000100000000000010010001
1001111111111001100111111111111110011001
