WWWWWWWWWWWWWWWWWWWWWWWWWWWWWWWWWWWWWWWW
W                                      W
W  WWWWWW  WWWWWW  WW  WWWWWW  WWWWWW  W
W  WWWWWW  WWWWWW  WW  WWWWWW  WWWWWW  W
W      WW      WW  WW      WW      WW  W
W  WWWWWW  WW  WWWWWW  WWWWWW  WWWWWW  W
W  WWWWWW  WW  WWWWWW  WWWWWW  WWWWWW  W
W      WW  WW      WW      WW      WW  W
W  WW  WW  WW  WWWWWWWWWW  WWWWWW  WWWWW
W  WW  WW  WW  WWWWWWWWWW  WWWWWW  WWWWW
W  WW  WW  WW          WW      WW      W
W  WWWWWWWWWW  WWWWWW  WWWWWWWWWWWWWW  W
W  WWWWWWWWWW  WWWWWW  WWWWWWWWWWWWWW  W
W          WW      WW              WW  W
W  WWWWWWWWWW  WWWWWWWWWWWWWW  WWWWWW  W
W  WWWWWWWWWW  WWWWWWWWWWWWWW  WWWWWW  W
W          WW              WW      WW  W
W  WW  WW  WWWWWWWWWWWWWW  WWWWWWWWWW  W
W  WW  WW  WWWWWWWWWWWWWW  WWWWWWWWWW  W
W  WW  WW              WW          WW  W
W  WW  WW  WW  WW  WW  WW  WWWWWW  WWWWW
W  WW  WW  WW  WW  WW  WW  WWWWWW  WWWWW
W  WW  WW  WW  WW  WW  WW      WW      W
W  WW  WWWWWW  WWWWWWWWWW  WWWWWWWWWW  W
W  WW  WWWWWW  WWWWWWWWWW  WWWWWWWWWW  W
W  WW      WW          WW          WW  W
W  WWWWWW  WW  WWWWWWWWWW  WWWWWW  WW  W
W  WWWWWW  WW  WWWWWWWWWW  WWWWWW  WW  W
W      WW  WW          WW      WW  WW  W
W  WW  WW  WWWWWWWWWWWWWW  WW  WW  WWWWW
W  WW  WW  WWWWWWWWWWWWWW  WW  WW  WWWWW
W  WW  WW              WW  WW  WW      W
W  WW  WWWWWWWWWW  WW  WWWWWWWWWW  WWWWW
W  WW  WWWWWWWWWW  WW  WWWWWWWWWW  WWWWW
W  WW          WW  WW          WW      W
W  WW  WW  WW  WWWWWWWWWWWWWWWWWWWWWW  W
W  WW  WW  WW  WWWWWWWWWWWWWWWWWWWWWW  W
W  WW  WW  WW                      WW  W
W  WW  WWWWWWWWWWWWWW  WW  WWWWWW  WW  W
W  WW  WWWWWWWWWWWWWW  WW  WWWWWW  WW  W
W  WW              WW  WW      WW  WW  W
W  WW  WW  WWWWWWWWWWWWWWWWWWWWWW  WW  W
W  WW  WW  WWWWWWWWWWWWWWWWWWWWWW  WW  W
W  WW  WW                      WW  WW  W
W  WWWWWWWWWW  WWWWWW  WWWWWW  WWWWWWWWW
W  WWWWWWWWWW  WWWWWW  WWWWWW  WWWWWWWWW
W          WW      WW      WW          W
W  WWWWWWWWWWWWWW  WW  WWWWWW  WW  WW  W
W  WWWWWWWWWWWWWW  WW  WWWWWW  WW  WW  W
W              WW  WW      WW  WW  WW  W
W  WWWWWWWWWW  WW  WW  WWWWWW  WW  WWWWW
W  WWWWWWWWWW  WW  WW  WWWWWW  WW  WWWWW
W          WW  WW  WW      WW  WW      W
W  WWWWWW  WW  WW  WW  WW  WWWWWWWWWW  W
W  WWWWWW  WW  WW  WW  WW  WWWWWWWWWW  W
W      WW  WW  WW  WW  WW          WW  W
W  WW  WW  WW  WW  WW  WW  WWWWWWWWWWWWW
W  WW  WW  WW  WW  WW  WW  WWWWWWWWWWWWW
W  WW  WW  WW  WW  WW  WW              W
WWWWWWWWWWWWWWWWWWWWWWWWWWWWWWWWWWWWWWWW
